111111111111111111111111
100000000000000100000001
100100000000000100000001
101000000000000100000001
100000111110000100000001
100000111110000100000001
100000111110000100000001
100000111110000100000001
100000111110000100000001
100000000000000100000001
100000000000000100000001
100000000000001000000001
100000000000000100000001
100000000000000100000001
110101010101010101010101
100000000000000000000001
100000000000000100000001
100000000000000100000001
111111111110000000001001
100000021110000000001001
120000000002000110001001
120000000002002100001001
100000220000000020001001
111111111111111111111111